oaprhplnricoyagl: pornographically
ortprtiieneeartn: reinterpretation
scaertsoielyplco: stereoscopically
viugnortsaacicrm: circumnavigators
ionesatsvnloeinc: conventionalises
litscoaspyeecrlo: stereoscopically
ticynnleivcoaiib: inconceivability
iapucaiztlenedrd: undercapitalized
sigyeppttontheot: phototypesetting
rsaiilstiduenerd: reindustrialised
tibntsemseadilhs: disestablishment
syastrrlaceililu: surrealistically
hnmceodiiifuiatd: dehumidification
nueecscsnuufslss: unsuccessfulness
ioislseroarercts: arteriosclerosis
nixaltisytieihub: inexhaustibility
riuolycatstafisn: unsatisfactorily
aaunirncicoimtvg: circumnavigation
yaliinebcncvoiit: inconceivability
yritlianivasmdte: administratively
iotaodaircncnnti: contraindication
aureamtiscnsictt: circumstantiates
rsionaduipesrtse: depressurisation
eispceastilrfuii: superficialities
hmpgrstceanireao: cinematographers
mlmliriaeuiltion: multimillionaire
usvectsionprrobi: oversubscription
aeltcsiilylcasec: ecclesiastically
tltacuaniylilasr: naturalistically
oodtiitbneslsrhs: bloodthirstiness
oycsnnlorcoyrcth: synchrocyclotron
rseeslgdbiseneaa: disagreeableness
eyaammlrocaltlid: melodramatically
itmaloifsfagirni: forisfamiliating
istnnmlmauoiilde: multidimensional
oglpbahiaauicotr: autobiographical
itelcaleilsyascc: ecclesiastically
rsthasicptsopyhe: psychotherapists
